  0   0   0   0   0   0   0   0   0   0   0   0   0   0   0   0   0   0   0   0   0   0   0   0   0   0   0   0   0   0 
  0   0   0   0   0   0   0   0   0   0   0   0   0   0   0   0   0   0   0   0   0   0   0   0   0   0   0   0   0   0 
  0   0   0   0   0   0   0   0   0   0   0   0   0   0   0   0   0   0   0   0   0   0   0   0   0   0   0   0   0   0 
  0   0   0   0   0   0   0   0   0   0   0   0   0   0   0   0   0   0   0   0   0   0   0   0   0   0   0   0   0   0 
  0   0   0   0   0   0   0   0   0   0   0   0   0   0   0   0   0   0   0   0   0   0   0   0   0   0   0   0   0   0 
 15  16  16  17   0   0   0   0   0   0   0   0   0   0   0   0   0   0   0   0   0   0   0   0   0   0  15  16  16  16 
 38  39  39  40   0   0   0   0   0   0   0   0   0   0   0   0   0   0   0   0   0   0   0   0   0   0  38  39  39  39 
 38  39  39  40   0   0   0   0   0   0   0   0   0   0   0   0   0   0   0   0   0   0   0   0   0   0  38  39  39  39 
 38  39  39  40   0   0   0   0   0   0  15  16  16  16  16  16  16  16  16  17   0   0   0   0   0   0  38  39  39  39 
 38  39  39  40   0   0   0   0   0   0  38 200 200 200 200 200 200 200 200  40   0   0   0   0   0   0  38  39  39  39 
 38  39  39  40   0   0   0   0   0   0  38 200 200 200 200 200 200 200 200  40   0   0   0   0   0   0  38  39  39  39 
111  39 111  40   0   0   0   0   0   0  38 200 200 272 200 200 272 200 200  40   0   0   0   0   0   0  38 111  39 111 
 38  39  39  40   0   0   0   0   0   0  38 200 200 200 200 200 200 200 200  40   0   0   0   0   0   0  38  39  39  39 
 38  39  39  40   0   0   0   0   0   0  38 200 200 200 200 200 271 200 200  40   0   0   0   0   0   0  38  39  39  39 
 38  39  39  40   0   0   0   0   0   0  38 200 200 200 200 272 203 272 200  40   0   0   0   0   0   0  38  39  39  39 
 38  39  39  40   0   0   0   0   0   0  38 200 200 200 200 200 226 200 200  40   0   0   0   0   0   0  38  39  39  39 
108  16  16  16  16  16  16  16  16  16  16 200 200 200  16  16  16  16  16  16  16  16  16  16  16  16  39  39  39  39 
 38 200 200 200 200 200 200 200 200 200 200 200 200 200 200 200 200 200 200 200 200 200 200 200 200 200 200 200 200  40 
 38 200 200 200 200 200 200 200 200 200 200 200 200 200 200 200 200 200 200 200 200 200 200 200 200 200 200 200 200  40 
 38 200 200 200 200 200 200 200 200 200 200 200 200 200 200 200 200 200 200 200 200 200 200 200 200 200 200 200 200  40 
 38 200 200 200 200 200 200 200 200 200 200 200 200 200 200 200 200 200 200 200 200 200 200 200 200 200 200 200 200  40 
 38 200 200 200 200 200 200 200 200 200 200 200 200 200 200 200 200 200 200 200 200 200 200 200 200 200 200 200 200  40 
 38 200 200 200 200 200 200 200 200 200  15  16  17 200 200 200 200 200 200 200 200 200 200 200 200 200 200 200 200  40 
 38 200 200 200 200 200 200 200 200 200 200 200 200 200 200 200 200 200 200 200 200 200 200 200 200 200 200 200 200  40 
 38 200 200 200 200 200 200 200 200 200 200 200 200 200 200 200 200 200 200 200 200 200 200 200 200 200 200 200 200  40 
 38 200 200 200  15  16  17 200 200 200 200 200 200 200 200 200 200 200 200 200 200 200 200 200 200 200 200 200 200  40 
 38 200 200 200 200 200 200 200 200 200 200 200 200 200 200 200 200 200 200 200 200 200 200 200 200 200 200 200 200  40 
 38 200 200 200 200 200 200 200 200 200 200 200 200 271 200 200 200 200 200 200 200 200 200 200 200 200 200 200 200  40 
 38 200 200 200 200 200 200 200 200 200 200 200 272 203 272 200 200 200 200 200 200 200 200 200 200 200 200 200 200  40 
 38 200 200 200 200 200 200 200 200 200 200 200 200 226 200 200 200 200 200 200 200 200 200 200 200 200 200 200 200  40 
 38  39  39  39  39  39  39  39  39  39  39  39  39  39  39  39 200 200  39 200 200 200 200 200 200  39  39  39  39  40 
 38  39  39  39  39  39  39  39  39  39  39  39  39  39  39  39 200 200  39 200 200 200 200 200 200  39  39  39  39  40 
 38  39  39  39  39  39  39  39  39  39  39  39  39  39  39  39 200 200  39 200 200 200 200 200 200  39  39  39  39  40 
 38  39  39  39  39  39  39  39  39  39  39  39  39  39  39  39 200 200  39 200 200 200 200 200 200  39  39  39  39  40 
 38  39  39  39  39  39  39  39  39  39  39  39  39  39  39  39 200 200  39 200 200  39  39  39  39  39  39  39  39  40 
 38  39  39  39  39  39  39  39  39  39  39  39  39  39  39  39 200 200 200 200 200 200 200  39  39  39  39  39  39  40 
 38  39  39  39  39  39  39  39  39  39  39  39  39  39  39  39 200 200 200 200 200 200 200  39  39  39  39  39  39  40 
 38  39  39  39  39  39  39  39  39  39  39  39  39  39  39  39 200 200 200 200 200 200 200  39  39  39  39  39  39  40 
 38  39  39  39  39  39  39  39  39  39  39  39  39  39  39  39 200 200 200 200 200 200 200  39  39  39  39  39  39  40 
 38  39  39  39  39  39  39  39  39  39  39  39  39  39  39  39 200 200 200  39 200 200 200  39  39  39  39  39  39  40 
 38 200 200 200 200 200 200 200 200 200 200 200 200 200 200 200 200 200 200  39 200 200 200  39  39  39  39  39  39  40 
 38 200 200 200 200 200 200 200 271 200 200 200 200 200 200 200 200 200 200  39 200 200 200  39  39  39  39  39  39  40 
 38 200 200 200 200 200 200 272 203 272 200 200 200 200 200 200 200  39  39  39 200 200 200  39  39  39  39  39  39  40 
 38 200 200 200 200 200 200 200 226 200 200 200 200 200 200 200 200  39  39  39 200 200 200  39  39  39  39  39  39  40 
 38 200 200  39  39  39  39  39  39  39  39  39  39  39  39  39  39  39  39  39 200 200 200  39  39  39  39  39  39  40 
 38 200 200 200 200 200 200 200 200 200 200 200 200 200 200 200 200  39  39  39 200 200 200  39  39  39  39  39  39  40 
 38 200 200 200 200 200 200 200 271 200 200 200 200 200 200 200 200  39  39  39 200 200 200  39  39  39  39  39  39  40 
 38 200 200 200 200 200 200 272 203 272 200 200 200 200 200 200 200  39  39  39 200 200 200  39  39  39  39  39  39  40 
 38 200 200 200 200 200 200 200 226 200 200 200 200 200 200 200 200  39  39  39 200 200 200  39  39  39  39  39  39  40 
 38  39  39  39  39  39  39  39  39  39  39  39 200 200 200 200 200  39  39  39 200 200 200  39  39  39  39  39  39  40 
 38 200 200 200 200 200 200 200 200 200 200 200 200 200 200 200 200 200 200 200 200 200 200 200 200 200 200 200 200  40 
 38 200 200 200 200 200 200 200 200 200 200 200 200 200 200 200 200 200 200 200 200 200 200 200 200 200 200 200 200  40 
 38 200 200 200 200 200 200 200 200 200 200 200 200 200 200 200 200 200 200 200 200 200 200 200 200 200 200 200 200  40 
 38 200 200 200 200 200 200 200 200 200 200 200 200 200 200 200 200 200 200 200 200 200 200 200 200 200 200 200 200  40 
 38 200 200 200 200 200 200 200 200 200 200 200 200 200 200 200 200 200 200 200 200 200 200 200 200 200 200 200 200  40 
 38 200 200 200 200 200 200 200 200 200 200 200 200 200 200 200 200 200 200 200 200 200 200 200 200 200 200 200 200  40 
 38 200 200 200 200 200 200 200 200 200 200 200 200 200  15  16  17 200 200 200 200 200 200 200 200 200 200 200 200  40 
 38 200 200 200 200 200 200 200 200 200 200 200 200 200 200 200 200 200 200 200 200 200 200 200 200 200 200 200 200  40 
 38 200 200 200 200 200 200 200 200 200 200 200 200 200 200 200 200 200 200 200 200 154 200 200 200 200 200 200 200  40 
 38 200 200 200 200 200 200 200 200 200 200 200 200 200 200 200 200 200 200 200 200 200 200 200 200 200 200 200 200  40 
 38 200 200 200 200 200 200 200 200 200 200 200 200 200 200 200 200 200 200 200 200 200 200 200 200 200 200 200 200  40 
 38 200 200 200 200 200 200 200 200 200 200 200 200 200 200 200 200 200 200 200 200 200 200 200 200 154 200 200 200  40 
 38 200 200 200 200 200 200 200 200 200 200 200 200 200 200 200 200 200 200 200 200 200 200 200 200 200 200 200 200  40 
 38 200 200 200 200 200 200 200 200 200 200 200 200 200 200 200 200 200 200 200 200 200 200 200 200 200 200 200 200  40 
 38 200 200 200 200 200 200 200 200 200 200 200 200 200 200 200 200 200 200 200 200 200 200 200 200 200 200 200 200  40 
 38 200 200 200 200 200 200  15  16  17 200 200 200 200 200 200 200 200 200 200 200 200 200 200 200 200 200 200 200  40 
 38 200 200 200 200 200 200 200 200 200 200 200 200 200 200 200 200  15  16  17 200 200 200 200 154 154 200 200 200  40 
 38 200 200 200 200 200 200 200 200 200 200 200 200 200 200 200 200 200 200 200 200 200 200 200 200 200 200 200 200  40 
 38 200 200 200 200 200 200 200 200 200 200 200 200 200 200 200 200 200 200 200 200 200 200 200 200 200 200 200 200  40 
 38 200 200 200 200 200 200 200 200 200 200 200 200 200 200 200 200 200 200 200 200 200 200 200 200 200 200 200 200  40 
 38 200 200 200 200 200 200 200 200 200 200  15  16  17 200 200 200 200 200 200 200 200 200 200 200 200 200 200 200  40 
 38 200 200 200 200 200 200 200 200 200 200 200 200 200 200 200 200 200 200 200 200 200 200 200 200 200 200 200 200  40 
 38 200 200 200 200 200 200 200 200 200 200 200 200 200 200 200 200 200 200 200 200 200 200 200 200 200 200 200 200  40 
 38 200 200 200  15  16  17 200 200 200 200 200 200 200 200 200 200 200 200 200 200 200 200 200 200 200 200 200 200  40 
 38 200 200 200 200 200 200 200 200 200 200 200 200 200 200 200 200 200 200 200 200 200 200 200 200 200 200 200 200  40 
 38 200 200 200 200 200 200 200 200 200 200 200 200 200 200 200 200 200 200 200 200 200 200 200 200 200 200 200 200  40 
 38 200 200 200 200 200 200 200 200 200 200 200 200 200 200 200 200 200 200 200 200 200 200 200 200 200 200 200 200  40 
 38 200 200 200 200 200 200 200 200  87  89 200 200 200 200 200 200 200 200 200 200 200 200 200 200 200 200 200 200  40 
 38 200 200 200 200 200 200 200 200 200 200 200 200 200 200 200 200 200 200 200 200 200 200 200 200 200 200 200 200  40 
 38 200 200 200 200 200 200 200 200 200 200 200 200 200 200 200 200 200 200 200 200 200 200 200 200 200 200 200 200  40 
 38 272 272 272 200 200 200 272 272 272 200 200 200 272 272 272 200 200 200 200 200 200 200 200 200 200 200 200 200  40 
 38 200 200 200 200 200 200 200 200 200 200 200 200 200 200 200 200 200 200 200 200 200 200 200 200 200 200 200 200  40 
 38 200 200 200 200 200 200 200 200 200 200 200 200 200 200 200 200 200 200 200 200 200 200 200 200 200 200 200 200  40 
 38  16  16  16  16  16  16  16  16  16  16  16  16  16  16  16  16  16  16  17 200 200 200 200 200 200 200 200 200  40 
 38 200 200 200 200 200 200 200 200 200 200 200 200 200 200 200 200 200 200 200 200 200 200 200 200 200 200 200 200  40 
 38 200 200 200 200 200 200 200 200 200 200 200 200 200 200 200 200 200 200 200 200 200 200 200 200 200 200 200 200  40 
 38 200 200 200 200 200 200 200 200 200 200 200 200 200 200 200 200 200 200 200 200 200 200 200 200 200 200 200 200  40 
 38 200 200 200 200 200 200 200 200 200 200 200 200 200 200 200 200 200 200 200 200 200 200 200 200 200 200 200 200  40 
 38 200 200 200 200 200 200 200 200 200 200 200 200 200 200 200 200 200 200 200 200 200 200 200 200 200 200 200 200  40 
 38 200 200 200 200 200 200 200 200 200 200 200 200 200 200 200 200 200 200 200 200 200 200 200 200 200 200 200 200  40 
 38 200 200 200 200 200 200 200 200 200 200 200 200 200 200 200 200 200 200 200 200 200 200 200 200 200 200 200 200  40 
 38 200 200 200 200 200 200 200 200 200 200 200 200 200 200 200 200 200 200 200 200 200 200 200 200 200 200 200 200  40 
 38 200 200 200 200 200 200 200 200 200 200 200 200 200 200 200 200 200 200 200 200 200 200 200  87  89 200 200 200  40 
 38 200 200 200 200 200 200 200 200 200 200 200 200 200 200 200 200 200 200 200 200 200 200 200 200 200 200 200 200  40 
 38 200 200 200 200 200 200 200 200 200 200 200 200 200 200 200 200 200 200 200 200 200 200 200 200 200 200 200 200  40 
 38 200 200 200 200 200 200 200 200 200 200 200 200 200 200 200 200 200 200 200 200 200 200 200 200 200 200 200 200  40 
 38 200 200 200 200 200 200 200 200 200 200 200 200 200 200 200 200 200 200 200 200 200 200 200 200 200 200 200 200  40 
 38 200 200 200 200 200 200 200 200 200 200 200 200 200 200 200 200 200 200 200 200 200 200 200 200 200 200 200 200  40 
 38 200 200 200 200 200 200 200 200 200 200 200 200  87  89 200 200 200 200 200 200 200 200 200  87  89 200 200 200  40 
 38 200 200 200 200 200 200 200 200 200 200 200 200 200 200 200 200 200 200 200 200 200 200 200 200 200 200 200 200  40 
 38 200 200 200 200 200 200 200 200 200 200 200 200 200 200 200 200 200 200 200 200 200 200 200 200 200 200 200 200  40 
 38 200 200 200 200 200 200 200 200 200 200 200 200 200 200 200 200 200 200 200 200 200 200 200 200 200 200 200 200  40 
 38 200 272 272 272 200 200 200 200 200 200 200 200 200 200 200 200 200 200 200 200 200 200 200 200 200 200 200 200  40 
 38 200 200 200 200 200 200 200 200 200 200 200 200 200 200 200 200 200 200 200 200 200 200 200 200 200 200 200 200  40 
 38  88  88  88  88  88  88 200 200 200 200 200 200 200 200 200 200 200 200 200 200 200 200 200 200 200 200 200 200  40 
 38 200 200 200 200 200 200 200 200 200 200 200 200 200 200 200 200 200 200 200 200 200 200 200 200 200 200 200 200  40 
 38 200 200 200 200 200 200 200 200 200 200 200 200 200 200 200 200 200 200 200 200 200 200 200 200 200 200 200 200  40 
 38 200 200 200 200 200 200 200 200 200  87  89 200 200 200 200 200 200 200 200 200 200 200 200 200 200 200 200 200  40 
 38 200 200 200 200 200 200 200 200 200 200 200 200 200 200 200 200 200 200 200 200 200 200 200 200 200 200 200 200  40 
 38 200 200 200 200 200 200 200 200 200 200 200 200 200 200 200 200 200 200 200 200 200 200 200 200 200 200 200 200  40 
 38 200 200 200 200 200 200 200 200 200 200 200 200 200 200 200 200 200 200 200 200 200 200 200 200 200 200 200 200  40 
 38 200 200 200 200 200 200 200 200 200 200 200 200 200 200 200 200 200 200 200 200 200 200 200 200 200 200 200 200  40 
 38 200 200 200 200 200 200 200 200 200 200 200 200 200 200 200 200 200 200 200 200 200 200 200 200 200 200 200 200  40 
 38 200 200 200 200 200 200 200 200 200 200 200 200 200 200 200 200 200 200 200 200 200 200 200 200 200 200 200 200  40 
 38 200 200 200 200 200 200 200 200 200 200 200 200 200 200 200 200 200 200 200 200 200 200 200 200 200 200 200 200  40 
 61  62  62  62  62  62  62  62  62  62  62  62  62  62  62  62  62  62  62  62  62  62 200 200 200 200 200 200 200  63 
  0   0   0   0   0   0   0   0   0   0   0   0   0   0   0   0   0   0   0   0   0   0   0   0   0   0   0   0   0   0 
  0   0   0   0   0   0   0   0   0   0   0   0   0   0   0   0   0   0   0   0   0   0   0   0   0   0   0   0   0   0 
  0   0   0   0   0   0   0   0   0   0   0   0   0   0   0   0   0   0   0   0   0   0   0   0   0  87  88  89   0   0 
  0   0   0   0   0   0   0   0   0   0   0   0   0   0   0   0   0   0   0   0   0   0   0   0   0   0  18   0   0   0 
  0   0   0   0   0   0   0   0   0   0   0   0   0   0   0   0   0   0   0   0   0   0   0   0   0   0  41   0   0   0 
  0   0   0   0   0   0   0   0   0   0   0   0   0   0   0   0   0   0   0   0   0  87  88  89   0   0  41   0   0   0 
  0   0   0   0   0   0   0   0   0   0   0   0   0   0   0   0   0   0   0   0   0   0  18   0   0   0  41   0   0   0 
  0   0   0   0   0   0   0   0   0   0   0   0   0   0   0   0   0   0   0   0   0   0  41   0   0   0  41   0   0   0 
  0   0   0   0   0   0   0   0   0   0   0   0   0   0   0   0   0  87  88  89   0   0  41   0   0   0  41   0   0   0 
  0   0   0   0   0   0   0   0   0   0   0   0   0   0   0   0   0   0  18   0   0   0  41   0   0   0  41   0   0   0 
  0   0   0   0   0   0   0   0   0   0   0   0   0   0   0   0   0   0  41   0   0   0  41   0   0   0  41   0   0   0 
  0   0   0   0   0   0   0   0   0   0   0   0   0   0   0   0   0   0  64   0   0   0  64   0   0   0  64   0   0   0 
  0   0   0   0   0   0   0   0   0  15  16  16  16  16  16  16  16  16  16  16  16  16  16  16  16  16  16  16  16  16 
  0   0   0   0   0   0   0   0   0  38  39  39  39  39  39  39  39  39  39  39  39  39  39  39  39  39  39  39  39  39 
  0   0   0  79  81   0   0   0   0   0   0   0   0   0   0   0   0   0   0   0   0   0   0   0   0   0   0   0   0   0 
  0   0   0   0   0   0   0   0   0   0   0   0   0   0   0   0   0   0   0   0   0   0   0   0   0   0   0   0   0   0 
  0   0   0   0   0   0   0   0   0   0   0   0   0   0   0   0   0   0   0   0   0   0   0   0   0   0   0   0   0   0 
  0   0   0   0   0   0   0   0   0   0   0   0   0   0   0   0   0   0   0   0   0   0   0   0   0   0   0   0   0   0 
  0   0   0  79  81   0   0   0  79  81   0   0   0   0   0   0   0   0   0   0   0   0   0   0   0   0   0   0   0   0 
  0   0   0   0   0   0   0   0   0   0   0   0   0   0  79  81   0   0   0   0   0   0   0   0   0   0   0   0   0   0 
  0   0   0   0   0   0   0   0   0   0   0   0   0   0   0   0   0   0   0   0   0   0   0   0   0   0   0   0   0   0 
  0   0   0   0   0   0   0   0   0   0   0   0   0   0   0   0   0   0   0   0  79  81   0   0   0   0   0   0   0   0 
  0   0   0   0   0   0   0   0   0   0   0   0   0   0   0   0   0   0   0   0   0   0   0   0   0   0   0   0   0   0 
  0   0   0   0   0   0   0   0   0   0   0   0   0   0   0   0   0   0   0   0   0   0   0   0   0   0   0   0   0   0 
  0   0   0   0   0   0   0   0   0   0   0   0   0   0   0   0   0   0   0   0   0   0   0   0   0   0  79  81   0   0 
  0   0   0   0   0   0   0   0   0   0   0   0   0   0   0   0   0   0   0   0   0   0   0   0   0   0   0   0   0   0 
  0   0   0   0   0   0   0   0   0   0   0   0   0   0   0   0   0   0   0   0   0   0   0   0   0   0   0   0   0   0 
  0   0   0   0   0   0   0   0   0   0   0   0   0   0   0   0   0   0   0   0   0   0  79  81   0   0   0   0   0   0 
  0   0   0   0   0   0   0   0   0   0   0   0   0   0   0  79  80  81   0   0   0   0   0   0   0   0   0   0   0   0 
  0   0   0   0   0   0   0   0   0   0   0   0   0   0   0   0   0   0   0   0   0   0   0   0   0   0   0   0   0   0 
  0   0   0   0   0   0   0   0   0   0   0   0   0   0   0   0   0   0   0   0  79  80  81   0   0   0   0   0   0   0 
  0   0   0   0  77  78   9   9   9   9   9 100 101   0   0   0   0   0   0   0   0   0   0   0   0   0   0   0   0   0 
  0   0   0   0   0  54  55  55  55  55  55  56   0   0   0   0   0   0   0   0   0   0   0   0   0   0   0   0   0   0 
  0   0   0   0   0   0   0   0   0   0   0   0   0   0   0   0   0   0   0   0   0   0   0   0   0   0   0   0   0   0 
  0   0   0   0   0   0   0   0   0   0   0   0   0   0   0   0   0   0   0   0   0   0   0   0   0   0   0   0   0   0 
  0   0   0   0   0   0   0   0   0   0   0   0   0   0   0   0   0   0   0   0   0   0   0   0   0   0   0   0   0   0 
  0   0   0   0   0   0   0   0   0   0   0   0   0   0   0   0   0   0   0   0   0   0   0   0   0   0   0   0   0   0 
  0   0   0   0   0   0   0   0   0   0   0   0   0   0   0   0   0   0   0   0   0   0   0   0   0   0   0   0   0   0 
  0   0   0   0  77  78   9   9   9   9   9 100 101   0   0   0   0   0   0   0   0   0   0   0   0   0   0   0   0   0 
  0   0   0   0   0  54  55  55  55  55  55  56   0   0   0   0   0   0   0   0   0   0   0   0   0   0   0   0   0   0 
  0   0   0   0   0   0   0   0   0   0   0   0   0   0   0   0   0   0   0   0   0   0   0   0   0   0   0   0   0   0 
  0   0   0   0   0   0   0   0   0   0   0   0   0   0   0   0   0   0   0   0   0   0   0   0   0   0   0   0   0   0 
  0   0   0   0   0   0   0   0   0   0   0   0   0   0   0   0   0   0   0   0   0   0   0   0   0   0   0   0   0   0 
  0   0   0   0   0   0   0   0   0   0   0   0   0   0   0   0   0   0   0   0   0   0   0   0   0   0   0   0   0   0 
  0   0   0   0   0   0   0   0   0   0   0   0   0   0   0   0   0   0   0   0   0   0   0   0   0   0   0   0   0   0 
  0   0   0   0   0   0   0   0   0   0   0   0   0   0   0   0   0   0   0   0   0   0   0   0   0   0   0   0   0   0 
  0   0 238 239 170 170 170 170 170 170 170 261 262   0   0   0   0   0   0   0   0   0 238 239 170 170 170 170 170 170 
  0   0   0 215 216 216 216 216 216 216 216 217   0   0   0   0   0   0   0   0   0   0   0 215 216 216 216 216 216 216 
  0   0   0   0   0   0   0   0   0   0   0   0   0   0   0   0 169 170 171   0   0   0   0   0   0   0   0   0   0   0 
  0   0   0   0   0   0   0   0   0   0   0   0   0   0   0   0 192 193 194   0   0   0   0   0   0   0   0   0   0   0 
  0   0   0   0   0   0   0   0   0   0   0   0   0   0   0   0 215 216 217   0   0   0   0   0   0   0   0   0   0   0 
  0   0   0   0   0   0   0   0   0   0   0   0   0   0   0   0   0   0   0   0   0   0   0   0   0   0   0   0   0   0 
  0   0   0   0   0   0   0   0   0   0   0   0   0   0   0   0   0   0   0   0   0   0   0   0   0   0   0   0   0   0 
  0   0   0   0   0   0   0   0   0   0   0   0   0   0   0   0   0   0   0   0   0   0 238 239 170 170 170 170 170 170 
  0   0   0   0   0   0   0   0   0   0   0   0   0   0   0   0   0   0   0   0   0   0   0 215 216 216 216 216 216 216 
  0   0   0   0   0   0   0   0   0   0   0   0   0   0   0   0   0   0   0   0   0   0   0   0   0   0   0   0   0   0 
  0   0   0   0   0   0   0   0   0   0   0   0   0   0   0   0   0   0   0   0   0   0   0   0   0   0   0   0   0   0 
  0   0   0   0   0   0   0   0   0   0   0   0   0   0   0   0   0   0   0   0   0   0   0   0   0   0   0   0   0   0 
  0   0   0   0   0   0   0   0   0   0   0   0   0   0   0   0   0   0   0   0   0   0   0   0   0   0   0   0   0   0 
  0   0   0   0   0   0   0   0   0   0   0   0   0   0   0   0   0   0   0   0   0   0   0   0   0   0   0   0   0   0 
  0   0   0   0   0   0   0   0   0   0   0 238 239 170 170 170 170 170 170 170 261 262   0   0   0   0   0   0   0   0 
  0   0   0   0   0   0   0   0   0   0   0   0 215 216 216 216 216 216 216 216 217   0   0   0   0   0   0   0   0   0 
  0   0   0   0   0   0   0   0   0   0   0   0   0   0   0   0   0   0   0   0   0   0   0   0   0   0   0   0   0   0 
170 170 170 170 170 170 261 262   0   0   0   0   0   0   0   0   0   0   0   0   0   0   0   0   0   0   0   0   0   0 
216 216 216 216 216 216 217   0   0   0   0   0   0   0   0   0   0   0   0   0   0   0   0   0   0   0   0   0   0   0 
  0   0   0   0   0   0   0   0   0   0   0   0   0   0   0   0   0   0   0   0   0   0   0   0   0   0   0   0   0   0 
  0   0   0   0   0   0   0   0   0   0   0   0   0   0   0   0   0   0   0   0   0   0   0   0   0   0   0   0   0   0 
  0   0   0   0   0   0   0   0   0   0 231 232 163 163 163 163 163 163 163 254 255   0   0   0   0   0   0   0   0   0 
  0   0   0   0   0   0   0   0   0   0   0 208 209 209 209 209 209 209 209 210   0   0   0   0   0   0   0   0   0   0 
  0   0   0   0   0   0   0   0   0   0   0   0   0   0   0   0   0   0   0   0   0   0   0 233 234 235   0   0   0   0 
  0   0   0   0   0   0   0   0   0   0   0   0   0   0   0   0   0   0   0   0   0   0   0   0   0   0   0   0   0   0 
  0   0   0   0   0   0   0   0   0   0   0   0   0   0   0   0   0   0   0   0   0   0   0   0   0   0   0   0   0   0 
  0   0   0   0   0   0   0   0   0   0   0   0   0   0   0   0   0   0   0   0   0   0   0   0   0   0   0   0   0   0 
  0   0   0   0   0   0   0   0   0   0   0   0   0   0   0   0   0   0   0   0   0   0   0   0   0   0   0   0   0   0 
  0   0   0   0   0   0   0   0   0   0   0   0   0   0   0   0   0   0   0   0   0   0   0   0   0   0   0   0   0   0 
  0   0   0   0   0   0   0   0   0   0   0   0   0   0   0   0   0   0   0   0   0   0   0 233 234 235   0   0   0   0 
163 163 163 163 163 163 163 163 163 163 254 255   0   0   0   0 233 234 235   0   0   0   0   0   0   0   0   0   0   0 
186 186 186 186 186 186 186 186 186 300 301   0   0   0   0   0   0   0   0   0   0   0   0   0   0   0   0   0   0   0 
209 209 209 209 209 209 209 209 209 301   0   0   0   0   0   0   0   0   0   0   0   0   0   0   0   0   0   0   0   0 
  0   0   0   0   0   0   0   0   0   0   0   0   0   0   0   0   0   0   0   0   0   0   0   0   0   0   0   0   0   0 
  0   0   0   0   0   0   0   0   0   0   0   0   0   0   0   0   0   0   0   0   0   0   0   0   0   0   0   0   0   0 
  0   0   0   0   0   0   0   0   0   0   0   0   0   0   0   0   0   0   0   0   0   0   0   0   0   0   0   0   0   0 
  0   0   0   0   0   0   0   0   0   0   0   0   0   0   0   0   0   0   0   0   0   0   0   0   0   0   0   0   0   0 
  0   0   0   0   0   0   0   0   0   0   0   0   0   0   0   0   0   0   0   0   0   0   0   0   0   0   0   0   0   0 
